"lang"
{
"Language"	"brazilian"
"Tokens"
{
"Overlay_Splash_Hotkey"	"Pressione %hotkey% para iniciar"
"[english]Overlay_Splash_Hotkey"	"Press %hotkey% to begin"
"Overlay_Splash_Message"	"Acesse a Comunidade Steam enquanto estiver jogando."
"[english]Overlay_Splash_Message"	"Access the Steam Community while playing."
"Overlay_SettingsTabTitle"	"Em jogo"
"[english]Overlay_SettingsTabTitle"	"In-game"
"Overlay_SettingsDescription"	"O Steam pode permanecer ativo e exibir mensagens de notificação da Comunidade Steam, assim como uma interface completa de amigos, enquanto estiver no seu jogo."
"[english]Overlay_SettingsDescription"	"Steam can remain active and present you with in-game Steam Community message notifications as well as with a full friends interface inside your game."
"Overlay_SettingsEnable"	"Ativar a Comunidade Steam dentro do jogo"
"[english]Overlay_SettingsEnable"	"Enable Steam Community In-Game"
"Overlay_SettingsHotKeyLabel"	"Teclas de atalho:"
"[english]Overlay_SettingsHotKeyLabel"	"Press shortcut keys:"
"Overlay_WebBrowserTitle"	"Navegador dentro do jogo"
"[english]Overlay_WebBrowserTitle"	"Web Browser In-Game"
"Overlay_Settings_Title"	"Steam - Configurações"
"[english]Overlay_Settings_Title"	"Steam - Settings"
"Overlay_Taskbar_Friends"	"Amigos"
"[english]Overlay_Taskbar_Friends"	"Friends"
"Overlay_Taskbar_Settings"	"Configurações"
"[english]Overlay_Taskbar_Settings"	"Settings"
"Overlay_Taskbar_Players"	"Jogadores"
"[english]Overlay_Taskbar_Players"	"Players"
"Overlay_Taskbar_Achievements"	"Conquistas"
"[english]Overlay_Taskbar_Achievements"	"Achievements"
"Overlay_Taskbar_News"	"Notícias"
"[english]Overlay_Taskbar_News"	"News"
"Overlay_Taskbar_GameGroups"	"Grupos do jogo"
"[english]Overlay_Taskbar_GameGroups"	"Game Groups"
"Overlay_Taskbar_ChatRoom"	"Sala de conversa"
"[english]Overlay_Taskbar_ChatRoom"	"Chat Room"
"Overlay_Taskbar_WebSite"	"Website"
"[english]Overlay_Taskbar_WebSite"	"Web Site"
"Overlay_Taskbar_Forums"	"Discussões"
"[english]Overlay_Taskbar_Forums"	"Discussions"
"Overlay_Taskbar_Close"	"Clique aqui para retornar ao jogo"
"[english]Overlay_Taskbar_Close"	"Click here to return to the game"
"Overlay_Taskbar_WebBrowser"	"Navegador"
"[english]Overlay_Taskbar_WebBrowser"	"Web Browser"
"Overlay_Taskbar_DLC"	"Conteúdo adicional"
"[english]Overlay_Taskbar_DLC"	"DLC"
"Overlay_Taskbar_Guide"	"Guia"
"[english]Overlay_Taskbar_Guide"	"Guide"
"Overlay_Taskbar_legacycdkey"	"Código de produto"
"[english]Overlay_Taskbar_legacycdkey"	"CD Key"
"Overlay_Hotkey_Explain"	"também fecha o painel"
"[english]Overlay_Hotkey_Explain"	"also closes the overlay"
"Overlay_Playtime_Stats"	"Tempo de jogo"
"[english]Overlay_Playtime_Stats"	"Playtime Stats"
"Overlay_Playtime_Intro"	"Você jogou este jogo"
"[english]Overlay_Playtime_Intro"	"You've played this game"
"Overlay_Playtime_TwoWeeksHours"	"%hours_twoweeks% horas nas duas últimas semanas"
"[english]Overlay_Playtime_TwoWeeksHours"	"%hours_twoweeks% hours - past two weeks"
"Overlay_Playtime_TwoWeeksMinutes"	"%minutes_twoweeks% minutos nas duas últimas semanas"
"[english]Overlay_Playtime_TwoWeeksMinutes"	"%minutes_twoweeks% minutes - past two weeks"
"Overlay_Playtime_ForeverHours"	"%hours_forever% horas no total"
"[english]Overlay_Playtime_ForeverHours"	"%hours_forever% hours - total"
"Overlay_Playtime_ForeverMinutes"	"%minutes_forever% minutos no total"
"[english]Overlay_Playtime_ForeverMinutes"	"%minutes_forever% minutes - total"
"Overlay_Playtime_Session"	"%minutes_session% minutos na sessão atual"
"[english]Overlay_Playtime_Session"	"%minutes_session% minutes - current session"
"Overlay_Friends_ThisManyOnline"	"%numfriends% amigo(s) online"
"[english]Overlay_Friends_ThisManyOnline"	"You have %numfriends% Friends online"
"Overlay_Friends_ThisManyInThisGame"	"Há %numfriends% amigo(s) neste servidor"
"[english]Overlay_Friends_ThisManyInThisGame"	"You have %numfriends% Friends on this game server"
"Overlay_Friends_ViewAll"	"Ver todos os amigos"
"[english]Overlay_Friends_ViewAll"	"View All Friends"
"Overlay_Friends_ViewPlayers"	"Ver jogadores"
"[english]Overlay_Friends_ViewPlayers"	"View Players"
"Overlay_Friends_ViewAchievements"	"Ver todas as conquistas"
"[english]Overlay_Friends_ViewAchievements"	"View All Achievements"
"Overlay_Friends_ViewNews"	"Ver todas as notícias"
"[english]Overlay_Friends_ViewNews"	"View All News"
"Overlay_Achievement_Title"	"Conquistas / %percent%%"
"[english]Overlay_Achievement_Title"	"Achievements / %percent%%"
"Overlay_Achievement_Progress"	"Você alcançou %earned% conquistas de %total%"
"[english]Overlay_Achievement_Progress"	"You've earned %earned% out of %total% achievements"
"Overlay_Achievement_Recent"	"+ recente"
"[english]Overlay_Achievement_Recent"	"Most Recent"
"Overlay_Achievement_Soon"	"Quase lá..."
"[english]Overlay_Achievement_Soon"	"So close..."
"Overlay_WebBrowser_Back"	"VOLTAR"
"[english]Overlay_WebBrowser_Back"	"BACK"
"Overlay_WebBrowser_Forward"	"AVANÇAR"
"[english]Overlay_WebBrowser_Forward"	"FORWARD"
"Overlay_WebBrowser_Reload"	"ATUALIZAR"
"[english]Overlay_WebBrowser_Reload"	"RELOAD"
"Overlay_WebBrowser_Stop"	"PARAR"
"[english]Overlay_WebBrowser_Stop"	"STOP"
"Overlay_WebBrowser_Home"	"INÍCIO"
"[english]Overlay_WebBrowser_Home"	"HOME"
"steam_menu_friends_view"	"Amigos"
"[english]steam_menu_friends_view"	"Friends"
"steam_menu_friends_sortbyname"	"Ordenar por nome"
"[english]steam_menu_friends_sortbyname"	"Sort by Name"
"steam_menu_friends_showavatars"	"Exibir avatares"
"[english]steam_menu_friends_showavatars"	"Show Avatars"
"steam_menu_friends_hideoffline"	"Exibir somente amigos online"
"[english]steam_menu_friends_hideoffline"	"Show Online Friends Only"
"steam_menu_friends_players"	"Jogadores"
"[english]steam_menu_friends_players"	"Players"
"steam_menu_friends_tools"	"Ferramentas"
"[english]steam_menu_friends_tools"	"Tools"
"steam_menu_friends_add"	"Adicionar um amigo..."
"[english]steam_menu_friends_add"	"Add a Friend..."
"steam_menu_friends_settings"	"Configurações"
"[english]steam_menu_friends_settings"	"Settings"
"friends_searchOnline"	"Buscar membros da Comunidade Steam"
"[english]friends_searchOnline"	"Search members of the Steam Community"
"Overlay_LowBattery_Message"	"Você tem %batteryTime% minutos de bateria restantes"
"[english]Overlay_LowBattery_Message"	"You have %batteryTime% minutes of battery power left"
"Overlay_CDKeyNotification_Message"	"Este jogo Steam requer um código de produto especial, exibido abaixo. Quando o jogo o pedir, insira-o como exibido aqui."
"[english]Overlay_CDKeyNotification_Message"	"This Steam game requires a special product key, shown below.  When the game asks for it, type it in as shown here."
"Overlay_CDKeyNotification_Message_MultipleKey"	"Este jogo Steam requer múltiplos códigos de produto. Quando o jogo pedir algum, você pode pressionar %hotkey% para ver os seus códigos de produto."
"[english]Overlay_CDKeyNotification_Message_MultipleKey"	"This Steam game requires multiple product keys. When the game asks for one, you can press %hotkey% to view your product keys."
"Overlay_CDKeyNotification_CDKey"	"%cdkey%"
"[english]Overlay_CDKeyNotification_CDKey"	"%cdkey%"
"Overlay_CDKeyNotification_Hotkey"	"Pressione %hotkey% para fechar essa mensagem"
"[english]Overlay_CDKeyNotification_Hotkey"	"Press %hotkey% to close this message"
"Overlay_CDKeyNotification_Title"	"Código de produto (CD Key) de %gamename%"
"[english]Overlay_CDKeyNotification_Title"	"%gamename% CD key"
"Overlay_DontNotifyAgain"	"Não me avise sobre isso novamente"
"[english]Overlay_DontNotifyAgain"	"Don't notify me about this again"
"Overlay_CDKeyDialog_NameColumn"	"Item"
"[english]Overlay_CDKeyDialog_NameColumn"	"Item"
"Overlay_CDKeyDialog_KeyColumn"	"Código de produto"
"[english]Overlay_CDKeyDialog_KeyColumn"	"Product Code"
"Overlay_LobbyInvite_WrongGame_Title"	"Convite de jogo"
"[english]Overlay_LobbyInvite_WrongGame_Title"	"Game Invitation"
"Overlay_LobbyInvite_WrongGame_Message"	"Esse convite é para um jogo que não é o que você está jogando nesse momento.\nPor favor, feche seu jogo atual e aceite esse convite pela sua área de trabalho."
"[english]Overlay_LobbyInvite_WrongGame_Message"	"This invitation is for a different game than the one you're currently playing.\nPlease close your current game, and accept the invitation from your desktop."
"Overlay_MicroTxnAuth_Title"	"Transação Steam"
"[english]Overlay_MicroTxnAuth_Title"	"Steam Transaction"
"Overlay_MicroTxnAuth_Authorize"	"Autorizar"
"[english]Overlay_MicroTxnAuth_Authorize"	"Authorize"
"Overlay_MicroTxnAuth_AddFunds"	"Adicionar fundos"
"[english]Overlay_MicroTxnAuth_AddFunds"	"Add Funds"
"Overlay_MicroTxnAuth_Cancel"	"Cancelar"
"[english]Overlay_MicroTxnAuth_Cancel"	"Cancel"
"Overlay_MicroTxnAuth_Description"	"%game% solicitou autorização para o seguinte:"
"[english]Overlay_MicroTxnAuth_Description"	"%game% has requested authorization for the following:"
"Overlay_MicroTxnAuth_Total"	"Total devido"
"[english]Overlay_MicroTxnAuth_Total"	"Total due"
"Overlay_MicroTxnAuth_Header_Name"	"Nome"
"[english]Overlay_MicroTxnAuth_Header_Name"	"Name"
"Overlay_MicroTxnAuth_Header_Price"	"Preço"
"[english]Overlay_MicroTxnAuth_Header_Price"	"Price"
"Overlay_MicroTxnAuth_header_Quantity"	"Qtd"
"[english]Overlay_MicroTxnAuth_header_Quantity"	"Qty"
"Overlay_MicroTxnAuth_Balance"	"%balance%"
"[english]Overlay_MicroTxnAuth_Balance"	"%balance%"
"Overlay_MicroTxnAuth_BalanceLabel"	"Seu saldo"
"[english]Overlay_MicroTxnAuth_BalanceLabel"	"Your Balance"
"Overlay_MicroTxnAuth_Tax"	"Impostos"
"[english]Overlay_MicroTxnAuth_Tax"	"Tax"
"Overlay_AccessibilityNotification_Message"	"Essa função requer Acesso Universal ativado nas Preferências do Sistema"
"[english]Overlay_AccessibilityNotification_Message"	"This feature requires Universal Access turned on from System Preferences."
"Overlay_MicroTxnCancelDlgTitle"	"Cancelar transação"
"[english]Overlay_MicroTxnCancelDlgTitle"	"Cancel Transaction"
"Overlay_MicroTxnCancelDlgText"	"Tem certeza de que gostaria de cancelar essa transação?"
"[english]Overlay_MicroTxnCancelDlgText"	"Are you sure you would like to cancel this transaction?"
"Overlay_MicroTxnCancelDlgOK"	"Cancelar transação"
"[english]Overlay_MicroTxnCancelDlgOK"	"Cancel Transaction"
"Overlay_MicroTxnCancelDlgCancel"	"Continuar transação"
"[english]Overlay_MicroTxnCancelDlgCancel"	"Continue Transaction"
"Overlay_SettingsScreenshotHotKeyLabel"	"Teclas de atalho para screenshot:"
"[english]Overlay_SettingsScreenshotHotKeyLabel"	"Screenshot shortcut keys:"
"Overlay_Taskbar_Recommend"	"Recomendar"
"[english]Overlay_Taskbar_Recommend"	"Recommend"
"Overlay_SettingsScreenshotActionLabel"	"Quando uma screenshot é tirada"
"[english]Overlay_SettingsScreenshotActionLabel"	"When a screenshot is taken"
"Overlay_Taskbar_Screenshots"	"Screenshots"
"[english]Overlay_Taskbar_Screenshots"	"Screenshots"
"Overlay_Screenshots_Title"	"Gerenciador de screenshots"
"[english]Overlay_Screenshots_Title"	"Screenshot Uploader"
"Overlay_Screenshots_Panel_Title"	"Screenshots"
"[english]Overlay_Screenshots_Panel_Title"	"Screenshots"
"Overlay_Screenshots_Show"	"Exibir:"
"[english]Overlay_Screenshots_Show"	"Show: "
"Overlay_View_All_Screenshots"	"Ver galeria online"
"[english]Overlay_View_All_Screenshots"	"View online library"
"Overlay_View_Screenshots"	"Visualizar screenshots"
"[english]Overlay_View_Screenshots"	"View screenshots"
"Overlay_View_Local"	"Exibir em disco"
"[english]Overlay_View_Local"	"Show on disk"
"Overlay_Set_Shortcut"	"Definir atalho"
"[english]Overlay_Set_Shortcut"	"Set shortcut"
"Overlay_Publish"	"Enviar"
"[english]Overlay_Publish"	"Upload"
"Overlay_Delete"	"Excluir"
"[english]Overlay_Delete"	"Delete"
"Overlay_Details"	"Ver online"
"[english]Overlay_Details"	"View Online"
"Overlay_Current_Session"	"Sessão atual"
"[english]Overlay_Current_Session"	"Current session"
"Overlay_Last_Session"	"Última sessão"
"[english]Overlay_Last_Session"	"Last session"
"Overlay_Chars_Left"	"%screenshot_caption_charsleft% caracteres restantes"
"[english]Overlay_Chars_Left"	"%screenshot_caption_charsleft% chars left"
"Overlay_Add_Caption"	"Adicionar uma legenda"
"[english]Overlay_Add_Caption"	"Add a caption"
"Overlay_Publish_Offline"	"Não é possível publicar screenshots no modo offline"
"[english]Overlay_Publish_Offline"	"Cannot publish screenshots in offline mode"
"Overlay_Screenshots_Press_Hotkey"	"Pressione %screenshot_hotkey% dentro do jogo para tirar screenshots."
"[english]Overlay_Screenshots_Press_Hotkey"	"Press %screenshot_hotkey% while in-game to take screenshots."
"Overlay_Publish_Error_Title"	"Erro"
"[english]Overlay_Publish_Error_Title"	"Error"
"Overlay_Publish_Error"	"Houve um erro ao publicar a screenshot. Por favor, tente novamente mais tarde."
"[english]Overlay_Publish_Error"	"There was an error publishing the screenshot.  Please try again later."
"Overlay_Publish_Error_Quota"	"Você não tem espaço suficiente na Nuvem para enviar essa screenshot"
"[english]Overlay_Publish_Error_Quota"	"You do not have enough Cloud space remaining to upload this screenshot"
"Overlay_Publish_Error_Quota_Plural"	"Você não tem espaço suficiente na Nuvem para enviar essas screenshots"
"[english]Overlay_Publish_Error_Quota_Plural"	"You do not have enough Cloud space remaining to upload these screenshots"
"Overlay_Delete_Screenshot_Error"	"Houve um erro ao excluir a screenshot. Por favor, tente novamente mais tarde."
"[english]Overlay_Delete_Screenshot_Error"	"There was an error deleting the screenshot.  Please try again later."
"Overlay_WebBrowser_OpenInNewTab"	"Abrir link em nova aba"
"[english]Overlay_WebBrowser_OpenInNewTab"	"Open Link In New Tab"
"Overlay_Share"	"Compartilhar no Facebook"
"[english]Overlay_Share"	"Share to Facebook"
"Overlay_ToBeSharedToFacebook"	"Screenshots compartilhadas no Facebook devem ser públicas."
"[english]Overlay_ToBeSharedToFacebook"	"If this screenshot is shared to Facebook, it will have public visibility settings."
"Overlay_WontBeSharedToFacebook"	"A opção de compartilhamento no Facebook é incompatível com o envio de mais de uma screenshot por vez."
"[english]Overlay_WontBeSharedToFacebook"	"Multiple screenshots can't be shared to Facebook."
"Overlay_ScreenshotOnSteam"	"Dê uma olhada nessa screenshot no Steam"
"[english]Overlay_ScreenshotOnSteam"	"Look at this screenshot on Steam"
"Overlay_ScreenshotOnSteamNamed"	"Dê uma olhada nessa screenshot de %gamename% no Steam"
"[english]Overlay_ScreenshotOnSteamNamed"	"Look at this screenshot of %gamename% on Steam"
"Overlay_PrivateScreenshot"	"Este aplicativo ainda não é público. Screenshots não podem ser definidas como públicas na Comunidade Steam e não podem ser compartilhadas no Facebook."
"[english]Overlay_PrivateScreenshot"	"This application is not public yet. Screenshots can't be made public on Steam Community and can't be shared to Facebook."
"Overlay_Screenshots_Size_Cloud"	"%selected_ss_size%"
"[english]Overlay_Screenshots_Size_Cloud"	"%selected_ss_size%"
"Overlay_Screenshots_Size_Original"	" (%selected_ss_size_original% em disco)"
"[english]Overlay_Screenshots_Size_Original"	" (%selected_ss_size_original% on disk)"
"Overlay_Taskbar_Workshop"	"Oficina"
"[english]Overlay_Taskbar_Workshop"	"Workshop"
"Overlay_SettingsHomepageLabel"	"Página inicial do navegador"
"[english]Overlay_SettingsHomepageLabel"	"Browser Home Page"
"Overlay_Taskbar_GameHub"	"Central da Comunidade"
"[english]Overlay_Taskbar_GameHub"	"Community Hub"
"Overlay_App"	"Aplicativo"
"[english]Overlay_App"	"Application"
"Overlay_Game"	"Jogo"
"[english]Overlay_Game"	"Game"
"Overlay_App_Lowercase"	"aplicativo"
"[english]Overlay_App_Lowercase"	"application"
"Overlay_Game_Lowercase"	"jogo"
"[english]Overlay_Game_Lowercase"	"game"
"Overlay_SettingsTabTitleApp"	"Em aplicativo"
"[english]Overlay_SettingsTabTitleApp"	"In-application"
"Overlay_SettingsDescriptionApp"	"O Steam pode permanecer ativo e exibir mensagens de notificação da Comunidade Steam, assim como uma interface completa de amigos, enquanto estiver no seu aplicativo."
"[english]Overlay_SettingsDescriptionApp"	"Steam can remain active and present you with in-application Steam Community message notifications as well as with a full friends interface inside your application."
"Overlay_SettingsEnableApp"	"Ativar a Comunidade Steam dentro do aplicativo"
"[english]Overlay_SettingsEnableApp"	"Enable Steam Community In-Application"
"Overlay_WebBrowserTitleApp"	"Navegador dentro do aplicativo"
"[english]Overlay_WebBrowserTitleApp"	"Web Browser In-Application"
"Overlay_Taskbar_CloseApp"	"Clique aqui para retornar ao aplicativo"
"[english]Overlay_Taskbar_CloseApp"	"Click here to return to the application"
"Overlay_Playtime_IntroApp"	"Você iniciou este aplicativo"
"[english]Overlay_Playtime_IntroApp"	"You've run this application"
"Overlay_CDKeyNotification_MessageApp"	"Este aplicativo Steam requer um código de produto especial, exibido abaixo. Quando o aplicativo o pedir, insira-o como exibido aqui."
"[english]Overlay_CDKeyNotification_MessageApp"	"This Steam application requires a special product key, shown below.  When the application asks for it, type it in as shown here."
"Overlay_CDKeyNotification_Message_MultipleKeyApp"	"Este aplicativo Steam requer múltiplos códigos de produto. Quando o aplicativo pedir algum, você pode pressionar %hotkey% para ver os seus códigos de produto."
"[english]Overlay_CDKeyNotification_Message_MultipleKeyApp"	"This Steam application requires multiple product keys. When the application asks for one, you can press %hotkey% to view your product keys."
"Overlay_Screenshots_Press_HotkeyApp"	"Pressione %screenshot_hotkey% dentro do aplicativo para tirar screenshots."
"[english]Overlay_Screenshots_Press_HotkeyApp"	"Press %screenshot_hotkey% while in-application to take screenshots."
"Overlay_Tag_As_Potential_Spoiler"	"Marcar como provável spoiler"
"[english]Overlay_Tag_As_Potential_Spoiler"	"Tag as potential spoiler"
"Overlay_Taskbar_SteamGuides"	"Guias da Comunidade"
"[english]Overlay_Taskbar_SteamGuides"	"Community Guides"
"Overlay_Guides_Panel_Title"	"Guias"
"[english]Overlay_Guides_Panel_Title"	"Guides"
"Overlay_View_Guides"	"Ver todos os guias"
"[english]Overlay_View_Guides"	"View All Guides"
"Overlay_Guides_Panel_NumGuides"	"%num_guides% disponível(eis)"
"[english]Overlay_Guides_Panel_NumGuides"	"%num_guides% available"
"Overlay_CommunityHub_Panel_Title"	"Central"
"[english]Overlay_CommunityHub_Panel_Title"	"Community Hub"
"Overlay_View_CommunityHub"	"Ver Central da Comunidade"
"[english]Overlay_View_CommunityHub"	"View Community Hub"
"Overlay_CommunityHub_Panel_NumContributions"	"%num_contributions% contribuições da comunidade"
"[english]Overlay_CommunityHub_Panel_NumContributions"	"%num_contributions% Community Contributions"
"Overlay_CommunityDiscussions_Panel_Title"	"Discussões"
"[english]Overlay_CommunityDiscussions_Panel_Title"	"Discussions"
"Overlay_View_CommunityDiscussions"	"Ver discussões"
"[english]Overlay_View_CommunityDiscussions"	"View Discussions"
"Overlay_CommunityDiscussions_Panel_NumDiscussions"	"%num_discussions% discussões ativas"
"[english]Overlay_CommunityDiscussions_Panel_NumDiscussions"	"%num_discussions% active discussions"
"Overlay_MicroTxnSubscription"	"%cost% serão cobrados a cada %time% %acct%"
"[english]Overlay_MicroTxnSubscription"	"You will be charged %cost% every %time% %acct%"
"Overlay_MicroTxnSubscriptionEvery"	"a cada"
"[english]Overlay_MicroTxnSubscriptionEvery"	"every"
"Overlay_MicroTxnSubscriptionAnnually"	"anualmente"
"[english]Overlay_MicroTxnSubscriptionAnnually"	"annually"
"Overlay_MicroTxnSubscriptionYears"	"ano(s)"
"[english]Overlay_MicroTxnSubscriptionYears"	"year(s)"
"Overlay_MicroTxnSubscriptionMonthly"	"mensalmente"
"[english]Overlay_MicroTxnSubscriptionMonthly"	"monthly"
"Overlay_MicroTxnSubscriptionMonths"	"mês(es)"
"[english]Overlay_MicroTxnSubscriptionMonths"	"month(s)"
"Overlay_MicroTxnSubscriptionWeekly"	"semanalmente"
"[english]Overlay_MicroTxnSubscriptionWeekly"	"weekly"
"Overlay_MicroTxnSubscriptionWeeks"	"semana(s)"
"[english]Overlay_MicroTxnSubscriptionWeeks"	"week(s)"
"Overlay_MicroTxnSubscriptionDaily"	"diariamente"
"[english]Overlay_MicroTxnSubscriptionDaily"	"daily"
"Overlay_MicroTxnSubscriptionDays"	"dia(s)"
"[english]Overlay_MicroTxnSubscriptionDays"	"day(s)"
"Overlay_SaveUncompressed"	"Salvar uma cópia não comprimida fora do Steam"
"[english]Overlay_SaveUncompressed"	"Save an uncompressed copy outside of Steam"
"Overlay_SetScreenshotFolder"	"Pasta externa de screenshots"
"[english]Overlay_SetScreenshotFolder"	"Select external screenshots folder"
"Overlay_SetScreenshotFolder_NoDriveRoot"	"Não é possível selecionar a raiz de um disco"
"[english]Overlay_SetScreenshotFolder_NoDriveRoot"	"You may not select the root of a drive"
"Overlay_SetScreenshotFolder_InvalidFolder"	"Você precisa selecionar uma pasta de screenshots válida"
"[english]Overlay_SetScreenshotFolder_InvalidFolder"	"You must select a valid screenshots folder"
"Overlay_FriendChangeConfirmation_Title"	"Confirmação de troca de amigo"
"[english]Overlay_FriendChangeConfirmation_Title"	"Friend Change Confirmation"
"Overlay_FriendChangeConfirmation_Confirm"	"Confirmar alteração"
"[english]Overlay_FriendChangeConfirmation_Confirm"	"Confirm Change"
"Overlay_FriendChangeConfirmation_Cancel"	"Cancelar"
"[english]Overlay_FriendChangeConfirmation_Cancel"	"Cancel"
"Overlay_FriendChangeConfirmation_Reason_Add"	"Deseja adicionar %persona% à sua lista de amigos?"
"[english]Overlay_FriendChangeConfirmation_Reason_Add"	"Would you like to add %persona% to your Friends list?"
"Overlay_FriendChangeConfirmation_Button_Add"	"Adicionar amigo"
"[english]Overlay_FriendChangeConfirmation_Button_Add"	"Add Friend"
"Overlay_FriendChangeConfirmation_Reason_Remove"	"Deseja remover %persona% da sua lista de amigos?"
"[english]Overlay_FriendChangeConfirmation_Reason_Remove"	"Would you like to remove %persona% from your Friends list?"
"Overlay_FriendChangeConfirmation_Button_Remove"	"Remover amigo"
"[english]Overlay_FriendChangeConfirmation_Button_Remove"	"Remove Friend"
"Overlay_FriendChangeConfirmation_Reason_RequestAccept"	"Deseja aceitar o pedido de amizade de %persona% e adicioná-lo(a) à sua lista de amigos?"
"[english]Overlay_FriendChangeConfirmation_Reason_RequestAccept"	"Would you like to accept the friend request from %persona% and add them to your Friends list?"
"Overlay_FriendChangeConfirmation_Button_RequestAccept"	"Aceitar pedido"
"[english]Overlay_FriendChangeConfirmation_Button_RequestAccept"	"Accept Request"
"Overlay_FriendChangeConfirmation_Reason_RequestIgnore"	"Deseja ignorar o pedido de amizade de %persona%?"
"[english]Overlay_FriendChangeConfirmation_Reason_RequestIgnore"	"Would you like to ignore the friend request from %persona%?"
"Overlay_FriendChangeConfirmation_Button_RequestIgnore"	"Ignorar pedido"
"[english]Overlay_FriendChangeConfirmation_Button_RequestIgnore"	"Ignore Request"
"Overlay_Publish_NeedWorkshopLegalAgreementAcceptance_Title"	"Acordo Legal da Oficina Steam"
"[english]Overlay_Publish_NeedWorkshopLegalAgreementAcceptance_Title"	"Steam Workshop Legal Agreement"
"Overlay_Publish_NeedWorkshopLegalAgreementAcceptance_Desc"	"Você deve aceitar o Acordo Legal da Oficina Steam mais recente para que o seu item seja publicado."
"[english]Overlay_Publish_NeedWorkshopLegalAgreementAcceptance_Desc"	"You need to accept the latest Steam Workshop Legal Agreement before your item is fully published."
"Overlay_Publish_NeedWorkshopLegalAgreementAcceptance_ViewItem"	"Ver item"
"[english]Overlay_Publish_NeedWorkshopLegalAgreementAcceptance_ViewItem"	"View item"
"Overlay_MicroTxnGameSubscription"	"como determinado pela sua conta no jogo"
"[english]Overlay_MicroTxnGameSubscription"	"as determined by your game account"
}
}
